Uu     , Re     , Xu     , Xu     , Xu     , Xu     , Xu     , Xu     , Xu     , Xu     , Xu     , Xu     , Xu     , Xu     , Xu     , Xu     , Xu     , Xu     , Xu     , Xu     
Uu     , Re     , Xu     , Xu     , Xu     , Xu     , Xu     , Xu     , Xu     , Xu     , Xu     , Xu     , Xu     , Xu     , Xu     , Xu     , Xu     , Xu     , Xu     , Xu     
Uu     , Rd     , Rd     , Uu     , Xu     , Uu     , Xu     , Uu     , Uu     , Uu     , Rd     , Uu     , Rd     , Re     , Re     , Xu     , Xu     , Xu     , Xu     , Xu     
Uu     , Uu     , Uu     , Uu     , Uu     , Uu     , Uu     , Uu     , Uu     , Rd     , Uu     , Uu     , Uu     , Xu     , Xu     , Xu     , Xu     , Xu     , Xu     , Xu     
Uu     , Xu     , Xu     , Xu     , Uu     , Xu     , Uu     , Uu     , Rd     , Rd     , Uu     , Rd     , Uu     , Xu     , Xu     , Xu     , Xu     , Xu     , Xu     , Xu     
Xu     , Xu     , Xu     , Xu     , Xu     , Xu     , Xu     , Uu     , Re     , Re     , Re     , Uu     , Uu     , Uu     , Xu     , Uu     , Xu     , Xu     , Xu     , Xu     
Xu     , Xu     , Xu     , Xu     , Xu     , Xu     , Xu     , Uu     , Re     , Uu     , Uu     , Xu     , Xu     , Xu     , Uu     , Xu     , Uu     , Uu     , Uu     , Xu     
Xu     , Xu     , Xu     , Xu     , Xu     , Xu     , Xu     , Uu     , Uu     , Uu     , Xu     , Xu     , Xu     , Xu     , Xu     , Xu     , Xu     , Uu     , Uu     , Xu     
Xu     , Xu     , Xu     , Re     , Xu     , Re     , Uu     , Uu     , Uu     , Uu     , Xu     , Xu     , Xu     , Xu     , Xu     , Xu     , Xu     , Xu     , Uu     , Xu     
Xu     , Xu     , Xu     , Uu     , Re     , Uu     , Uu     , Uu     , Rd     , Re     , Xu     , Xu     , Xu     , Xu     , Xu     , Xu     , Xu     , Xu     , Uu     , Xu     
Xu     , Xu     , Xu     , Uu     , Uu     , Xu     , Uu     , Uu     , Re     , Re     , Xu     , Xu     , Xu     , Xu     , Xu     , Xu     , Xu     , Re     , Uu     , Xu     
Xu     , Xu     , Xu     , Xu     , Xu     , Xu     , Xu     , Re     , Re     , Uu     , Xu     , Xu     , Xu     , Xu     , Xu     , Xu     , Xu     , Xu     , Uu     , Xu     
Xu     , Xu     , Xu     , Xu     , Xu     , Xu     , Xu     , Uu     , Uu     , Uu     , Uu     , Xu     , Xu     , Xu     , Xu     , Xu     , Xu     , Xu     , Uu     , Xu     
Xu     , Xu     , Xu     , Xu     , Xu     , Uu     , Uu     , Rd     , Rd     , Re     , Uu     , Uu     , Xu     , Xu     , Xu     , Xu     , Xu     , Uu     , Uu     , Xu     
Xu     , Xu     , Xu     , Uu     , Uu     , Uu     , Uu     , 1 _K   , Re     , Re     , Re     , Uu     , Uu     , Uu     , Uu     , Uu     , Uu     , Uu     , Xu     , Xu     
Xu     , Xu     , Xu     , Uu     , Uu     , Uu     , Uu     , Uu     , Rd     , Uu     , Uu     , Uu     , Uu     , Xu     , Rd     , Rd     , Rd     , Uu     , Xu     , Xu     
Xu     , Xu     , Xu     , Re     , Re     , Re     , Uu     , Uu     , Uu     , Xu     , Uu     , Uu     , Xu     , Xu     , Xu     , Xu     , Re     , Uu     , Xu     , Xu     
Xu     , Xu     , Xu     , Xu     , Re     , Uu     , Uu     , Uu     , Xu     , Xu     , Xu     , Xu     , Xu     , Xu     , Xu     , Xu     , Re     , Uu     , Xu     , Xu     
Xu     , Xu     , Xu     , Xu     , Xu     , Uu     , Uu     , Uu     , Xu     , Xu     , Xu     , Xu     , Xu     , Xu     , Xu     , Xu     , Re     , Re     , Uu     , Xu     
Xu     , Xu     , Xu     , Xu     , Xu     , Uu     , Re     , Re     , Re     , Uu     , Xu     , Xu     , Xu     , Xu     , Xu     , Xu     , Xu     , Xu     , Xu     , Xu     
