Mm          , Mm          , Vhm         , Mm          , Mm          , Mm          , Mm          , Mm          , Mm          , Hh          , Mm          , Mm          , Mm          , Mm          , Mm          , Hh          , Mm          , Ww          , Hh          , Hh          , Mm          , Mm          , Mm          , Mm          , Mm          , Hh          , Mm          , Mm          , Mm          , Mm          
Mm          , Hh          , Mm          , Mm          , Mm          , Mm          , Mm          , Mm          , Mm          , Mm          , Mm          , Mm          , Mm          , Mm          , Mm          , Hh          , Ww          , Ww          , Ww          , Hh          , Mm          , Hh          , Vhh         , Ff          , Mm          , Hh          , Hh          , Mm          , Mm          , Mm          
Ff          , Ff          , Hh          , Hh          , Mm          , Hh          , Mm          , Hh          , Mm          , Vhm         , Mm          , Mm          , Mm          , Mm          , Vhm         , Mm          , Hh          , Hh          , Ww          , Gg          , Hh          , Rr          , Gg          , Rr          , Ff          , Rr          , Hh          , Hh          , Hh          , Mm          
Ce          , Ce          , Ce          , Ce          , Hh          , Rr          , Hh          , Rr          , Hh          , Hh          , Hh          , Hh          , Mm          , Mm          , Mm          , Hh          , Hh          , Hh          , Vhg         , Rr          , Rr          , Gg          , Rr          , Hh          , Rr          , Hh          , Rr          , Rr          , Hh          , Hh          
Ce          , Ce          , 1 _K        , Ce          , Rr          , Hh          , Rr          , Hh          , Rr          , Rr          , Hh          , Rr          , Hh          , Hh          , Hh          , Ggf         , Ggf         , Rr          , Rr          , Hh          , Hh          , Mm          , Mm          , Hh          , Cud         , 2 _K        , Cud         , Hh          , Rr          , Rr          
Ce          , Hh          , Ce          , Mm          , Hh          , Mm          , Hh          , Veg         , Hh          , Gg          , Rr          , Gg          , Rr          , Rr          , Hh          , Rr          , Rr          , Hh          , Hh          , Mm          , Mm          , Mm          , Mm          , Mm          , Cud         , Cud         , Cud         , Hh          , Rr          , Gg          
Mm          , Mm          , Mm          , Mm          , Mm          , Mm          , Mm          , Hh          , Gg          , Hh          , Hh          , Mm          , Hh          , Hh          , Rr          , Hh          , Hh          , Vhh         , Mm          , Mm          , Mm          , Mm          , Mm          , Mm          , Mm          , Mm          , Hh          , Rr          , Rr          , Veg         
Mm          , Vhm         , Mm          , Hh          , Mm          , Mm          , Mm          , Mm          , Hh          , Mm          , Mm          , Mm          , Mm          , Mm          , Gg          , Hh          , Hh          , Mm          , Mm          , Mm          , Hh          , Mm          , Mm          , Mm          , Mm          , Mm          , Mm          , Mm          , Rr          , Hh          
Hh          , Hh          , Hh          , Hh          , Hh          , Vhm         , Mm          , Mm          , Mm          , Hh          , Hh          , Ww          , Hh          , Ww          , Vhg         , Hh          , Hh          , Hh          , Mm          , Hh          , Mm          , Hh          , Mm          , Mm          , Mm          , Hh          , Mm          , Mm          , Rr          , Hh          
Ss          , Ss          , Ss          , Hh          , Mm          , Hh          , Mm          , Hh          , Mm          , Hh          , Ww          , Wo          , Ww          , Ww          , Wwf         , Wwf         , Hh          , Ww          , Hh          , Ww          , Hh          , Ww          , Hh          , Ww          , Hh          , Ww          , Hh          , Hh          , Rr          , Mm          
Ww          , Ww          , Ww          , Ww          , Hh          , Ww          , Hh          , Ss          , Hh          , Ww          , Ww          , Wo          , Wo          , Wo          , Ww          , Wwf         , Ww          , Wo          , Ww          , Wo          , Ww          , Wo          , Ww          , Wo          , Ww          , Ww          , Ww          , Veg         , Rr          , Mm          
Wo          , Wo          , Wo          , Wo          , Ww          , Wo          , Ww          , Ww          , Ww          , Ww          , Ww          , Wo          , Wo          , Wo          , Ww          , Wwf         , Ww          , Wo          , Wo          , Wo          , Wo          , Ww          , Wo          , Ww          , Wo          , Ww          , Hh          , Hh          , Rr          , Mm          
Wo          , Wo          , Wo          , Wo          , Wo          , Wo          , Wo          , Wo          , Wo          , Wo          , Wo          , Wo          , Wo          , Ww          , Ww          , Wwf         , Ww          , Ww          , Ww          , Ww          , Ww          , Hh          , Ww          , Hh          , Ww          , Ww          , Mm          , Hh          , Rr          , Hh          
Wo          , Wo          , Wo          , Wo          , Wo          , Wo          , Wo          , Wo          , Wo          , Wo          , Wo          , Ww          , Ww          , Ww          , Ww          , Wwf         , Wwf         , Hh          , Ww          , Hh          , Hh          , Mm          , Mm          , Hh          , Veg         , Rr          , Ww          , Ww          , Bww|        , Ww          
Ww          , Ww          , Wo          , Ww          , Wo          , Ww          , Wo          , Wo          , Wo          , Wo          , Wo          , Ww          , Hh          , Hh          , Hh          , Mm          , Hh          , Hh          , Hh          , Mm          , Mm          , Hh          , Hh          , Rr          , Rr          , Mm          , Rr          , Rr          , Rr          , Mm          
Ww          , Ss          , Ww          , Ss          , Ww          , Vhg         , Ww          , Ww          , Ww          , Ww          , Ww          , Hh          , Hh          , Mm          , Mm          , Mm          , Mm          , Gg          , Mm          , Mm          , Mm          , Hh          , Mm          , Rr          , Hh          , Hh          , Mm          , Mm          , Veg         , Mm          
Hh          , Hh          , Ss          , Hh          , Hh          , Mm          , Hh          , Hh          , Ss          , Hh          , Ss          , Hh          , Hh          , Mm          , Mm          , Hh          , Veg         , Gg          , Hh          , Hh          , Hh          , Hh          , Hh          , Rr          , Hh          , Mm          , Mm          , Mm          , Mm          , Mm          
Mm          , Mm          , Hh          , Mm          , Mm          , Mm          , Hh          , Mm          , Hh          , Mm          , Hh          , Mm          , Mm          , Hh          , Mm          , Hh          , Hh          , Hh          , Hh          , Ff          , Ff          , Ff          , Gg          , Rr          , Gg          , Hh          , Mm          , Mm          , Mm          , Mm          
Mm          , Mm          , Mm          , Mm          , Mm          , Mm          , Mm          , Mm          , Mm          , Mm          , Mm          , Mm          , Mm          , Hh          , Hh          , Gg          , Hh          , Gg          , Hh          , Rr          , Rr          , Rr          , Rr          , Hh          , Hh          , Hh          , Mm          , Mm          , Mm          , Mm          
Mm          , Mm          , Mm          , Veg         , Mm          , Hh          , Mm          , Hh          , Mm          , Hh          , Veg         , Hh          , Hh          , Hh          , Gg          , Rr          , Rr          , Rr          , Rr          , Hh          , Hh          , Mm          , Veg         , Hh          , Hh          , Mm          , Mm          , Mm          , Mm          , Mm          
Mm          , Hh          , Hh          , Gg          , Hh          , Hh          , Hh          , Hh          , Hh          , Hh          , Gg          , Gg          , Hh          , Rr          , Rr          , Mm          , Hh          , Veg         , Mm          , Mm          , Mm          , Mm          , Hh          , Hh          , Hh          , Mm          , Mm          , Mm          , Mm          , Mm          
Hh          , Hh          , Gg          , Hh          , Hh          , Chr         , Hh          , Hh          , Hh          , Hh          , Hh          , Gg          , Rr          , Hh          , Mm          , Mm          , Mm          , Mm          , Mm          , Mm          , Mm          , Mm          , Mm          , Mm          , Mm          , Mm          , Chr         , Mm          , Mm          , Mm          
Hh          , Re          , Re          , Re          , Re          , Re          , Rr          , Rr          , Mm          , Rr          , Rr          , Rr          , Rr          , Mm          , Mm          , Mm          , Mm          , Mm          , Mm          , Mm          , Mm          , Mm          , Mm          , Mm          , Mm          , Chr         , Chr         , Chr         , Mm          , Mm          
Gg          , Re          , Gg          , Ff          , Gg          , Hh          , Chr         , Hh          , Rr          , Hh          , Hh          , Hh          , Mm          , Mm          , Mm          , Mm          , Mm          , Mm          , Mm          , Hh          , Mm          , Mm          , Mm          , Mm          , Chr         , Chr         , 3 _K        , Chr         , Mm          , Mm          
Re          , Gg          , Ff          , Hh          , Hh          , Mm          , Hh          , Mm          , Veg         , Mm          , Mm          , Mm          , Mm          , Mm          , Mm          , Mm          , Mm          , Mm          , Mm          , Hh          , Hh          , Mm          , Mm          , Mm          , Chr         , Chr         , Chr         , Chr         , Mm          , Mm          
Re          , Gg          , Hh          , Mm          , Mm          , Mm          , Mm          , Mm          , Mm          , Mm          , Mm          , Mm          , Mm          , Mm          , Veg         , Mm          , Mm          , Mm          , Mm          , Mm          , Mm          , Mm          , Mm          , Mm          , Mm          , Mm          , Mm          , Mm          , Mm          , Mm          
Re          , Re          , Hh          , Mm          , Mm          , Mm          , Mm          , Mm          , Mm          , Mm          , Mm          , Mm          , Mm          , Mm          , Mm          , Mm          , Mm          , Mm          , Mm          , Mm          , Mm          , Mm          , Mm          , Mm          , Mm          , Mm          , Mm          , Mm          , Mm          , Mm          
Gg          , Re          , Hh          , Hh          , Mm          , Veg         , Hh          , Hh          , Hh          , Hh          , Mm          , Hh          , Mm          , Mm          , Mm          , Mm          , Mm          , Mm          , Mm          , Mm          , Mm          , Mm          , Mm          , Hh          , Mm          , Hh          , Mm          , Hh          , Veg         , Hh          
Gg          , Re          , Ggf         , Gg          , Hh          , Hh          , Hh          , Hh          , Hh          , Hh          , Hh          , Hh          , Hh          , Mm          , Mm          , Veg         , Hh          , Hh          , Mm          , Mm          , Mm          , Hh          , Mm          , Hh          , Hh          , Ff          , Hh          , Hh          , Ff          , Gg          
Veg         , Hh          , Re          , Re          , Ggf         , Gg          , Ggf         , Ggf         , Gg          , Gg          , Hh          , Gg          , Hh          , Hh          , Hh          , Ff          , Hh          , Hh          , Hh          , Hh          , Hh          , Hh          , Hh          , Ff          , Ff          , Ff          , Hh          , Hh          , Hh          , Gg          
Hh          , Hh          , Hh          , Hh          , Re          , Re          , Re          , Re          , Gg          , Gg          , Gg          , Re          , Gg          , Re          , Gg          , Ff          , Ff          , Ff          , Ff          , Ff          , Ff          , Ff          , Ff          , Veg         , Ff          , Ff          , Ff          , Hh          , Hh          , Veg         
Mm          , Mm          , Mm          , Hh          , Hh          , Hh          , Gg          , Gg          , Re          , Re          , Re          , Ggf         , Re          , Ggf         , Re          , Re          , Hh          , Hh          , Ff          , Ff          , Ff          , Ff          , Ff          , Ff          , Ff          , Hh          , Ff          , Hh          , Ff          , Gg          
Mm          , Mm          , Hh          , Veg         , Hh          , Mm          , Hh          , Gg          , Gg          , Gg          , Gg          , Ggf         , Ggf         , Ggf         , Ggf         , Re          , Hh          , Hh          , Hh          , Gg          , Ff          , Hh          , Hh          , Hh          , Hh          , Hh          , Hh          , Ff          , Hh          , Hh          
Mm          , Hh          , Hh          , Hh          , Hh          , Hh          , Hh          , Gg          , Gg          , Gg          , Ss          , Gg          , Gg          , Gg          , Re          , Hh          , Hh          , Hh          , Hh          , Hh          , Hh          , Hh          , Hh          , Ff          , Ff          , Ff          , Ff          , Ff          , Hh          , Hh          
Hh          , Veg         , Hh          , Ff          , Hh          , Ff          , Hh          , Gg          , Gg          , Ff          , Gg          , Gg          , Gg          , Gg          , Re          , Hh          , Hh          , Veg         , Hh          , Hh          , Hh          , Hh          , Ff          , Ff          , Ff          , Ff          , Ff          , Ff          , Ff          , Ff          
Hh          , Ff          , Ff          , Ff          , Ff          , Ff          , Ff          , Ff          , Ff          , Ff          , Ff          , Veg         , Gg          , Re          , Re          , Gg          , Hh          , Hh          , Hh          , Hh          , Hh          , Hh          , Hh          , Hh          , Ff          , Ff          , Veg         , Ff          , Ff          , Ff          
Ff          , Ff          , Ff          , Ff          , Ff          , Ss          , Ff          , Ff          , Ff          , Ff          , Ff          , Ggf         , Gg          , Re          , Ce          , Re          , Ff          , Ff          , Ff          , Ff          , Ff          , Ff          , Hh          , Ff          , Hh          , Ff          , Ff          , Ss          , Ss          , Ff          
Ff          , Veg         , Ff          , Ff          , Ff          , Ff          , Ff          , Ff          , Ff          , Ff          , Ff          , Ff          , Re          , Gg          , Re          , Re          , Ff          , Ff          , Ff          , Ff          , Ff          , Ff          , Ff          , Ff          , Ff          , Ff          , Ff          , Ff          , Ss          , Ff          
