Xu     , Xu     , Xu     , Xu     , Xu     , Xu     , Xu     , Xu     , Mm     , Mm     , Mm     , Hh     , Gg     , Gg     , Gg     , Re     , Gg     , Re     , Ff     , Mm     , Mm     , Xu     , Xu     , Xu     , Xu     , Xu     , Xu     , Xu     , Xu     , Xu     
Xu     , Xu     , Xu     , Xu     , Xu     , Xu     , Xu     , Xu     , Xu     , Hh     , Vhh    , Re     , Re     , Ce     , Ce     , Ce     , Re     , Re     , Vhh    , Hh     , Mm     , Xu     , Xu     , Xu     , Xu     , Xu     , Xu     , Xu     , Xu     , Xu     
Xu     , Xu     , Xu     , Xu     , Xu     , Xu     , Xu     , Xu     , Xu     , Rd     , Hh     , Rd     , Rd     , Ce     , 2 _K   , Ce     , Rd     , Rd     , Rd     , Rd     , Xu     , Xu     , Xu     , Xu     , Xu     , Xu     , Xu     , Xu     , Xu     , Xu     
Qxu    , Qxu    , Xu     , Xu     , Xu     , Xu     , Xu     , Xu     , Xu     , Uf     , Rd     , Uf     , Uf     , Ce     , Ce     , Ce     , Rd     , Uu     , Uh     , Uf     , Xu     , Xu     , Xu     , Xu     , Xu     , Xu     , Xu     , Xu     , Xu     , Xu     
Xu     , Xu     , Qxu    , Xu     , Xu     , Xu     , Xu     , Xu     , Uh     , Uu     , Uu     , Uh     , Uf     , Uu     , Uu     , Uu     , Uu     , Uu     , Uf     , Uf     , Uh     , Xu     , Xu     , Xu     , Xu     , Xu     , Xu     , Xu     , Xu     , Xu     
Xu     , Xu     , Qxu    , Xu     , Xu     , Xu     , Xu     , Xu     , Uh     , Uu     , Uu     , Uu     , Uu     , Uu     , Uu     , Uu     , Uu     , Uu     , Uu     , Uu     , Uh     , Xu     , Xu     , Xu     , Xu     , Xu     , Xu     , Xu     , Xu     , Xu     
Xu     , Xu     , Qxu    , Xu     , Xu     , Xu     , Xu     , Xu     , Xu     , Uu     , Cud    , Cud    , Cud    , Uu     , Uu     , Uu     , Cud    , Cud    , Cud    , Uu     , Xu     , Xu     , Xu     , Xu     , Xu     , Xu     , Xu     , Xu     , Xu     , Xu     
Xu     , Xu     , Qxu    , Qxu    , Xu     , Uu     , Uu     , Uu     , Uu     , Vu     , Rr     , Rr     , Rr     , Uu     , Uu     , Uu     , Rr     , Rr     , Rr     , Vu     , Uu     , Uu     , Xu     , Xu     , Uu     , Uf     , Xu     , Uu     , Xu     , Xu     
Xu     , Xu     , Xu     , Xu     , Uu     , Uu     , Uu     , Uf     , Uf     , Uf     , Uu     , Uu     , Rr     , Cud    , Cud    , Cud    , Rr     , Uu     , Uu     , Uu     , Uu     , Uu     , Uu     , Uu     , Uu     , Uf     , Uf     , Uu     , Uu     , Xu     
Xu     , Uu     , Uu     , Uu     , Uu     , Uh     , Uu     , Uu     , Uf     , Uf     , Uu     , Uu     , Rr     , Rr     , _K     , Rr     , Rr     , Uu     , Uu     , Uu     , Uu     , Uh     , Uu     , Vu     , Uu     , Uu     , Uf     , Uu     , Uu     , Xu     
Xu     , Xu     , Uu     , Uu     , Uh     , Uh     , Uh     , Uu     , Uu     , Uu     , Uu     , Rr     , Rr     , Uh     , Rr     , Uf     , Rr     , Rr     , Uu     , Uu     , Uu     , Uh     , Uh     , Uh     , Uu     , Uu     , Uu     , Xu     , Xu     , Xu     
Xu     , Xu     , Uf     , Uu     , Uh     , Uu     , Vu     , Uu     , Uu     , Rr     , Rr     , Uu     , Uu     , Uu     , Rr     , Vu     , Uf     , Uh     , Rr     , Rr     , Uu     , Uu     , Uh     , Uu     , Uu     , Uu     , Xu     , Xu     , Xu     , Xu     
Xu     , Uf     , Uf     , Uu     , Uu     , Uu     , Uu     , Rr     , Rr     , Uu     , Uu     , Uu     , Uu     , Uf     , Rr     , Uf     , Uu     , Uu     , Uh     , Uu     , Rr     , Rr     , Uu     , Uu     , Uu     , Uu     , Uf     , Uf     , Uf     , Xu     
Xu     , Uu     , Uu     , Uu     , Uu     , Uu     , Uu     , Rr     , Uu     , Uu     , Uu     , Uf     , Uf     , Cud    , Rr     , Cud    , Uf     , Uf     , Uu     , Uu     , Uu     , Rr     , Uu     , Uu     , Uu     , Uf     , Uf     , Ww     , Ww     , Xu     
Xu     , Ww     , Xu     , Xu     , Uu     , Uh     , Uh     , Rr     , Uh     , Uh     , Uh     , Uf     , Uf     , Ww     , Rr     , Ww     , Wo     , Wo     , Uu     , Uu     , Cud    , Bww|   , Cud    , Ww     , Uu     , Uu     , Uf     , Ww     , Ww     , Wo     
Wo     , Ww     , Ww     , Wo     , Uh     , Uh     , Cud    , Bww|   , Cud    , Ww     , Wo     , Wo     , Wo     , Cud    , Bww|   , Cud    , Uf     , Uf     , Wo     , Ww     , Ww     , Bww|   , Ww     , Xu     , Ww     , Ww     , Ww     , Uu     , Xu     , Xu     
Xu     , Ww     , Uf     , Uf     , Wo     , Wo     , Ww     , Bww|   , Ww     , Uh     , Uf     , Uu     , Uf     , Uf     , Rr     , Uu     , Uf     , Uu     , Uu     , Uu     , Ww     , Rr     , Ww     , Ww     , Ww     , Uu     , Uu     , Uu     , Xu     , Xu     
Xu     , Uu     , Uf     , Uu     , Uf     , Uh     , Cud    , Rr     , Cud    , Uh     , Uu     , Uu     , Uu     , Uu     , Rr     , Uu     , Uu     , Uu     , Uu     , Uu     , Cud    , Rr     , Cud    , Uu     , Uu     , Uu     , Uu     , Uu     , Uu     , Xu     
Xu     , Xu     , Xu     , Xu     , Uu     , Uu     , Uh     , Uu     , Rr     , Rr     , Uu     , Uf     , Uf     , Vud    , Rr     , Uu     , Uh     , Uf     , Uu     , Rr     , Rr     , Uu     , Uu     , Uu     , Uu     , Uu     , Uu     , Uu     , Uu     , Xu     
Xu     , Uu     , Xu     , Uf     , Uf     , Vud    , Uu     , Uu     , Uu     , Uf     , Rr     , Rr     , Uh     , Uh     , Rr     , Uh     , Uh     , Rr     , Rr     , Uu     , Uu     , Uu     , Uu     , Uf     , Uu     , Uu     , Uu     , Uu     , Uu     , Xu     
Xu     , Uu     , Uu     , Uf     , Uf     , Uf     , Uu     , Uu     , Uu     , Uu     , Uf     , Uu     , Rr     , Rr     , Rr     , Rr     , Rr     , Uh     , Uh     , Uu     , Uu     , Uu     , Uf     , Uf     , Vud    , Uf     , Uu     , Uu     , Uu     , Xu     
Xu     , Uu     , Uu     , Uu     , Uf     , Uu     , Uu     , Uh     , Uu     , Uu     , Uu     , Uh     , Uh     , Uh     , Rr     , Uf     , Uh     , Uu     , Uu     , Uu     , Uu     , Uu     , Uf     , Uf     , Uf     , Uu     , Uu     , Xu     , Xu     , Xu     
Xu     , Xu     , Uu     , Uu     , Qxu    , Uu     , Uu     , Uu     , Uh     , Uu     , Uu     , Uu     , Uh     , Uu     , Rr     , Uf     , Uu     , Uu     , Uu     , Uu     , Uu     , Uu     , Uu     , Uu     , Uu     , Uu     , Xu     , Xu     , Xu     , Xu     
Xu     , Xu     , Xu     , Xu     , Qxu    , Xu     , Uu     , Vud    , Uu     , Cud    , Cud    , Cud    , Uu     , Uu     , Rr     , Uu     , Uu     , Cud    , Cud    , Cud    , Uu     , Xu     , Xu     , Uu     , Uu     , Qxu    , Qxu    , Qxu    , Xu     , Xu     
Xu     , Xu     , Xu     , Xu     , Qxu    , Xu     , Uu     , Uu     , Uu     , Uu     , Rr     , Rr     , Uu     , Cud    , Rr     , Cud    , Uu     , Rr     , Rr     , Uu     , Uu     , Xu     , Xu     , Xu     , Xu     , Xu     , Qxu    , Qxu    , Qxu    , Qxu    
Xu     , Xu     , Xu     , Qxu    , Qxu    , Xu     , Xu     , Xu     , Xu     , Uu     , Uu     , Uu     , Rr     , Cud    , Cud    , Cud    , Rr     , Uu     , Uu     , Uu     , Vud    , Xu     , Xu     , Xu     , Xu     , Xu     , Xu     , Xu     , Qxu    , Qxu    
Xu     , Qxu    , Qxu    , Xu     , Xu     , Xu     , Xu     , Xu     , Uu     , Uh     , Vud    , Uu     , Uu     , Cud    , 1 _K   , Cud    , Uu     , Vud    , Uh     , Uf     , Xu     , Xu     , Xu     , Xu     , Xu     , Xu     , Xu     , Xu     , Xu     , Qxu    
Qxu    , Xu     , Xu     , Xu     , Xu     , Xu     , Xu     , Xu     , Uf     , Uf     , Uh     , Uu     , Uu     , Rr     , Cud    , Rr     , Uu     , Uu     , Uf     , Uf     , Uf     , Xu     , Xu     , Xu     , Xu     , Xu     , Xu     , Xu     , Xu     , Qxu    
Xu     , Xu     , Xu     , Xu     , Xu     , Xu     , Xu     , Xu     , Xu     , Uf     , Uf     , Uu     , Uu     , Rr     , Rr     , Rr     , Uu     , Uu     , Uh     , Uf     , Uf     , Xu     , Xu     , Xu     , Xu     , Xu     , Xu     , Xu     , Xu     , Qxu    
Xu     , Xu     , Xu     , Xu     , Xu     , Xu     , Xu     , Xu     , Xu     , Uf     , Uf     , Uu     , Uu     , Rr     , Rr     , Rr     , Uh     , Uu     , Uu     , Uu     , Xu     , Xu     , Xu     , Xu     , Xu     , Xu     , Xu     , Xu     , Xu     , Qxu    
